cl=?
pau=Asp
sil=Sil
br=br1
u=M
N=N\
ry=4'
ky=k'
py=p'
dy=d'
ty=t'
ny=J
hy=C
my=m'
gy=g'
by=b'
sh=S
j=dZ
z=dz
f=p\
f y=p\'
ch=tS
r=4
y=j
v=p\
k i=k' i
g i=g' i
t i=t' i
d i=d' i
n i=J i
h i=C i
f i=p\' i
b i=b' i
p i=p' i
m i=m' i
r i=4' i
v i=p\' i